12,12,12,12,12,12,12,12,12,12,12,12
12,26,26,26,26,26,26,26,26,26,26,12
12,26,26,26,26,26,26,26,26,26,26,12
12,21,26,26,0,0,0,0,26,26,19,12
12,21,26,26,0,0,0,0,26,26,18,12
12,21,26,26,26,26,26,26,26,26,18,12
12,21,26,26,26,32,26,26,26,26,18,12
12,26,26,26,26,26,26,26,26,26,26,12
12,26,26,26,25,25,25,25,26,26,26,12
12,12,12,12,12,12,12,12,12,12,12,12
